####################
#..................#
#.......2RG........#
#.....##.#####.....#
#...D1.SS..........#
#####.........D....#
#.....##.....#######
###................#
#....#####.....E...#
#...........#####..#
#P.3...............#
####################
