####################
#..................#
#............2RG...#
#............#####.#
#..................#
#.......#####......#
#..D1.SS...........#
#.#####.......###E.#
#..........###.....#
#....#####.........#
#P.3...............#
####################
