####################
#..................#
#.........G........#
#.....##.#####.....#
#...D..............#
#####.........D....#
#.....##.....#######
###................#
#....#####.....E...#
#...........#####..#
#P.................#
####################
