####################
#..................#
#............G.....#
#..........#####...#
#..................#
#......#####.......#
#..D...............#
#.#####..........E.#
#..............#####
#........#####.....#
#P.................#
####################
