####################
#..................#
#..................#
#..........G.......#
#........#####.....#
#..................#
#......#####.......#
#..................#
#....#####......E..#
#..#............####
#P.............#####
####################
