####################
#..................#
#..............G...#
#............#####.#
#..................#
#.......#####......#
#..D...............#
#.#####.......###E.#
#..........###.....#
#....#####.........#
#P.................#
####################
