####################
#..................#
#...........RG.....#
#..........#####...#
#..................#
#......#####.......#
#..D...SS..........#
######..........E..#
#..............#####
#......#######.....#
#P.C....C..........#
####################
